####################
#.S..#.............#
#....#.....#.......#
#....#.....#.......#
#....#.....#.......#
#....#.....#.......#
#....#.....#.......#
#....#.....#...T...#
#..........#.......#
####################
